grass

X X X 0 0 W W M
X X 0 0 W W M 1
0 0 0 W W W M 0
0 0 0 0 0 0 2 0
0 M W W W 0 0 0
0 M 0 W 0 0 0 3
M W W W 0 0 X X
W W 1 0 0 X X X